1111111111111111111111111
1ECC00000000000C000000001
1C11010100100001000010101
1010010010101010000010101
1P000CC00C00C0000011100C1
100C000000000000010010001
110C00000001000011101C111
1C0C0000000000001001C0011
1111111111111111111111111