1111111111111
100000000PC11
1100011111001
1C1011E000001
1111111111111