1111111111111111111111111111111111
1ECC00000000000C00000C000000000001
1C10010100100000101001000000010101
1010010010101010001001000000010101
1P000CC00C00C0000011100000000000C1
100C000000000000010001000000000001
110C00000000000001000000011101C011
1C0C0000000000001000000000000C0011
1111111111111111111111111111111111