1111111
1C0P001
1E00111
10000C1
1111111