1111111111111
1P00000000C11
11000111110E1
1C00110000001
1111111111111