1111111111111
1000EC0000111
11101111100P1
1C00110000001
1111111111111