1111111111111111111111111
10CC00000000000C000000001
1010010010101010000010101
1P000CC00C00C000001110001
100C0000000E0000010010001
110C000000010000111010111
1C0C000000000000000000011
1C0C000000000000000000011
1C0C000000000000000000011
1111111111111111111111111