1111111111111
1000011111001
10010000000C1
1P0011E000001
1111111111111