1111111111111
1000000000C11
11000111110E1
1C00110P00001
1111111111111