11111
1CPE1
10001
10001
10001
11111